{

  "beach": [

    { "MAPA_ARCADE": "01",
      "blockers": 90,
      "grid": [
        [3,0,0,0,1,1,0,0,0,1,1,0,0,0,3],
        [0,1,0,7,1,0,0,1,0,0,1,7,0,1,0],
        [0,1,0,4,0,0,1,1,1,0,0,4,0,1,0],
        [0,0,0,7,1,8,8,0,8,8,1,7,0,0,0],
        [1,0,1,1,1,8,1,1,1,8,1,1,1,0,1],
        [1,8,1,0,0,0,2,2,2,0,0,0,1,0,1],
        [0,8,8,0,1,1,2,2,2,1,1,0,8,8,0],
        [1,0,1,0,0,0,2,2,2,0,0,0,1,8,1],
        [1,0,1,1,1,8,1,1,1,8,1,1,1,0,1],
        [0,0,0,7,1,8,8,0,8,8,1,7,0,0,0],
        [0,1,0,4,0,0,1,1,1,0,0,4,0,1,0],
        [0,1,0,7,1,0,0,1,0,0,1,7,0,1,0],
        [3,0,0,0,1,1,0,0,0,1,1,0,0,0,3]
      ]
    },
    { "MAPA_ARCADE": "02",
      "blockers": 90,
      "grid": [
        [3,0,0,0,0,0,0,0,0,0,0,0,0,0,3],
        [0,1,0,1,1,0,7,4,7,0,1,1,0,1,0],
        [0,1,8,8,0,0,0,0,0,0,0,8,8,1,0],
        [0,1,1,8,1,0,1,1,1,0,1,8,1,1,0],
        [0,0,0,0,8,8,0,0,0,8,8,0,0,0,0],
        [0,7,1,0,1,8,2,2,2,8,1,0,1,7,0],
        [0,4,0,0,0,0,2,2,2,0,0,0,0,4,0],
        [0,7,1,0,1,8,2,2,2,8,1,0,1,7,0],
        [0,0,0,0,8,8,0,0,0,8,8,0,0,0,0],
        [0,1,1,8,1,0,1,1,1,0,1,8,1,1,0],
        [0,1,8,8,0,0,0,0,0,0,0,8,8,1,0],
        [0,1,0,1,1,0,7,4,7,0,1,1,0,1,0],
        [3,0,0,0,0,0,0,0,0,0,0,0,0,0,3]
      ]
    }
  ],

  "forest": [

    { "MAPA_ARCADE": "01",
      "blockers": 90,
      "grid": [
        [3,0,0,0,0,0,0,0,0,0,0,0,0,0,3],
        [0,1,1,1,7,1,1,0,1,1,7,1,1,1,0],
        [0,1,0,1,4,7,0,0,0,7,4,1,0,1,0],
        [0,1,0,1,7,1,0,1,0,1,7,1,0,1,0],
        [0,0,0,0,0,0,0,0,0,0,0,0,0,0,0],
        [0,1,1,1,1,0,2,2,2,0,1,1,1,1,0],
        [0,7,4,7,0,0,2,2,2,0,0,7,4,7,0],
        [0,1,1,1,1,0,2,2,2,0,1,1,1,1,0],
        [0,0,0,0,0,0,0,0,0,0,0,0,0,0,0],
        [0,1,0,1,7,1,0,1,0,1,7,1,0,1,0],
        [0,1,0,1,4,7,0,0,0,7,4,1,0,1,0],
        [0,1,1,1,7,1,1,0,1,1,7,1,1,1,0],
        [3,0,0,0,0,0,0,0,0,0,0,0,0,0,3]
      ]
    },
    { "MAPA_ARCADE": "02",
      "blockers": 90,
      "grid": [
        [3,0,0,0,0,0,7,4,7,0,0,0,0,0,3],
        [0,1,0,1,1,1,0,1,0,1,1,1,0,1,0],
        [0,1,0,0,0,0,0,1,0,0,0,0,0,1,0],
        [0,1,1,0,1,0,1,1,1,0,1,0,1,1,0],
        [0,0,0,0,0,0,0,0,0,0,0,0,0,0,0],
        [0,1,1,0,1,0,2,2,2,0,1,0,1,1,0],
        [0,7,4,7,0,0,2,2,2,0,0,7,4,7,0],
        [0,1,1,0,1,0,2,2,2,0,1,0,1,1,0],
        [0,0,0,0,0,0,0,0,0,0,0,0,0,0,0],
        [0,1,1,0,1,0,1,1,1,0,1,0,1,1,0],
        [0,1,0,0,0,0,0,1,0,0,0,0,0,1,0],
        [0,1,0,1,1,1,0,1,0,1,1,1,0,1,0],
        [3,0,0,0,0,0,7,4,7,0,0,0,0,0,3]
      ]
    },
	{ "MAPA_ARCADE": "03",
      "blockers": 90,
      "grid": [
        [3,0,0,0,0,0,1,0,1,0,0,0,0,0,3],
        [0,1,1,1,1,0,1,0,1,0,1,1,1,1,0],
        [0,7,4,7,0,0,0,0,0,0,0,7,4,7,0],
        [0,1,1,1,1,1,1,0,1,1,1,1,1,1,0],
        [0,0,0,0,0,0,0,0,0,0,0,0,0,0,0],
        [0,1,1,1,1,0,2,2,2,0,1,1,1,1,0],
        [0,0,0,7,4,7,2,2,2,7,4,7,0,0,0],
        [0,1,1,1,1,0,2,2,2,0,1,1,1,1,0],
        [0,0,0,0,0,0,0,0,0,0,0,0,0,0,0],
        [0,1,1,1,1,1,1,0,1,1,1,1,1,1,0],
        [0,7,4,7,0,0,0,0,0,0,0,7,4,7,0],
        [0,1,1,1,1,0,1,0,1,0,1,1,1,1,0],
        [3,0,0,0,0,0,1,0,1,0,0,0,0,0,3]
      ]
    }
  ],

  "ranch": [

    { "MAPA_ARCADE": "01",
      "blockers": 90,
      "grid": [
        [3,0,0,0,0,0,0,0,0,0,0,0,0,0,3],
        [0,1,1,1,0,1,0,1,0,1,0,1,1,1,0],
        [0,0,0,1,0,1,0,1,0,1,0,1,0,0,0],
        [0,1,4,7,7,0,0,0,0,0,7,7,4,1,0],
        [0,1,7,1,1,0,1,0,1,0,1,1,7,1,0],
        [0,0,7,0,0,0,2,2,2,0,0,0,7,0,0],
        [1,1,0,1,1,0,2,2,2,0,1,1,0,1,1],
        [0,0,7,0,0,0,2,2,2,0,0,0,7,0,0],
        [0,1,7,1,1,0,1,0,1,0,1,1,7,1,0],
        [0,1,4,7,7,0,0,0,0,0,7,7,4,1,0],
        [0,0,0,1,0,1,0,1,0,1,0,1,0,0,0],
        [0,1,1,1,0,1,0,1,0,1,0,1,1,1,0],
        [3,0,0,0,0,0,0,0,0,0,0,0,0,0,3]
      ]
    },
    { "MAPA_ARCADE": "02",
      "blockers": 90,
      "grid": [
        [3,0,0,0,0,0,0,0,0,0,0,0,0,0,3],
        [0,1,1,1,1,0,1,0,1,0,1,1,1,1,0],
        [0,1,4,7,7,0,1,1,1,0,7,7,4,1,0],
        [0,1,7,1,1,0,1,0,1,0,1,1,7,1,0],
        [0,0,7,0,0,0,0,0,0,0,0,0,7,0,0],
        [0,1,1,1,0,1,2,2,2,1,0,1,1,1,0],
        [0,0,0,0,0,0,2,2,2,0,0,0,0,0,0],
        [0,1,1,1,0,1,2,2,2,1,0,1,1,1,0],
        [0,0,7,0,0,0,0,0,0,0,0,0,7,0,0],
        [0,1,7,1,1,0,1,0,1,0,1,1,7,1,0],
        [0,1,4,7,7,0,1,1,1,0,7,7,4,1,0],
        [0,1,1,1,1,0,1,0,1,0,1,1,1,1,0],
        [3,0,0,0,0,0,0,0,0,0,0,0,0,0,3]
      ]
    }
  ],

  "race_track": [

    { "MAPA_ARCADE": "01",
      "blockers": 90,
      "car_white": [[4,4],[11,4],[11,6],[4,6]],
	  "car_red": [[10,9],[10,7],[3,7],[3,9]],
      "grid": [
        [3,0,0,0,0,0,0,1,0,0,0,0,0,0,3],
        [0,1,0,1,1,0,1,1,1,0,1,1,0,1,0],
        [0,0,0,4,7,7,0,0,0,7,7,4,0,1,0],
        [0,1,0,1,1,0,1,0,1,0,1,1,1,0,0],
        [0,1,0,1,5,5,5,5,5,5,5,5,1,1,0],
        [0,1,0,0,5,1,2,2,2,1,1,5,0,1,0],
        [0,0,0,1,5,5,2,2,2,5,5,5,1,1,0],
        [0,1,1,5,5,5,2,2,2,5,5,1,0,0,0],
        [0,1,0,5,1,1,1,1,1,1,5,0,0,1,0],
        [0,1,1,5,5,5,5,5,5,5,5,1,0,1,0],
        [0,0,1,1,1,0,1,0,1,0,1,1,0,0,0],
        [0,1,0,0,7,7,4,0,4,7,7,0,0,1,0],
        [3,0,0,1,0,1,1,0,1,1,0,1,0,0,3]
      ]
    },
    { "MAPA_ARCADE": "02",
      "blockers": 90,
      "car_white": [[4,2],[8,2],[8,3],[11,3],[11,7],[10,7],[10,10],[6,10],[6,9],[3,9],[3,5],[4,5]],
	  "car_red": [[9,9],[9,6],[10,6],[10,4],[7,4],[7,3],[5,3],[5,6],[4,6],[4,8],[7,8],[7,9]],
      "grid": [
        [3,0,0,1,1,7,7,4,0,0,1,0,0,0,3],
        [0,1,0,0,0,0,1,1,1,0,1,1,0,1,0],
        [0,0,0,1,5,5,5,5,5,0,4,0,0,0,0],
        [0,1,0,0,5,5,5,5,5,5,5,5,1,0,1],
        [0,0,0,1,5,5,1,5,5,5,5,5,0,0,1],
        [1,0,1,5,5,5,2,2,2,1,5,5,1,0,1],
        [1,0,1,5,5,5,2,2,2,5,5,5,1,0,1],
        [0,0,0,5,5,1,2,2,2,5,5,5,1,0,1],
        [1,0,1,5,5,5,5,5,1,5,5,1,0,0,0],
        [1,0,1,5,5,5,5,5,5,5,5,0,0,1,0],
        [0,0,0,0,4,0,5,5,5,5,5,1,0,0,0],
        [0,1,0,1,1,0,1,1,1,0,0,0,0,1,0],
        [3,0,0,0,1,0,0,4,7,7,1,1,0,0,3]
      ]
    }
  ]
}