{

  "maps": [
    { "MAPA_ARCADE": "01",
      "blockers": 90,
      "grid": [
        [3,0,0,0,0,0,0,1,0,0,0,0,0,0,3],
        [0,1,1,0,1,1,0,1,0,1,1,0,1,1,0],
        [0,0,1,0,1,0,0,0,0,0,1,0,1,0,0],
        [1,0,0,0,0,0,1,1,1,0,0,0,0,0,1],
        [0,0,1,0,1,0,0,0,0,0,1,0,1,0,0],
        [0,1,1,0,1,0,2,2,2,0,1,0,1,1,0],
        [0,0,0,0,0,0,2,2,2,0,0,0,0,0,0],
        [0,1,1,0,1,0,2,2,2,0,1,0,1,1,0],
        [0,0,1,0,1,0,0,0,0,0,1,0,1,0,0],
        [1,0,0,0,0,0,1,1,1,0,0,0,0,0,1],
        [0,0,1,0,1,0,0,0,0,0,1,0,1,0,0],
        [0,1,1,0,1,1,0,1,0,1,1,0,1,1,0],
        [3,0,0,0,0,0,0,1,0,0,0,0,0,0,3]
      ]
    },
    { "MAPA_ARCADE": "02",
      "blockers": 90,
      "grid": [
        [3,0,1,0,0,0,0,1,0,0,0,0,1,0,3],
        [0,1,0,0,1,1,0,1,0,1,1,0,0,1,0],
        [0,1,1,0,1,0,0,0,0,0,1,0,1,1,0],
        [0,1,0,0,0,0,1,1,1,0,0,0,0,1,0],
        [0,0,0,1,1,0,0,0,0,0,1,1,0,0,0],
        [1,1,0,1,1,0,2,2,2,0,1,1,0,1,1],
        [0,1,0,0,0,0,2,2,2,0,0,0,0,1,0],
        [0,1,0,1,1,0,2,2,2,0,1,1,0,1,0],
        [0,0,0,1,1,0,0,0,0,0,1,1,0,0,0],
        [0,1,0,0,0,0,1,1,1,0,0,0,0,1,0],
        [0,1,1,0,1,0,0,0,0,0,1,0,1,1,0],
        [0,1,0,0,1,1,0,1,0,1,1,0,0,1,0],
        [3,0,1,0,0,0,0,1,0,0,0,0,1,0,3]
      ]
    },
    { "MAPA_ARCADE": "03",
      "blockers": 90,
      "grid": [
        [3,0,0,0,1,0,1,1,1,0,1,0,0,0,3],
        [0,1,1,0,0,0,0,0,0,0,0,0,1,1,0],
        [0,0,1,0,1,1,0,1,0,1,1,0,1,0,0],
        [1,0,0,0,0,0,0,1,0,0,0,0,0,0,1],
        [1,0,1,0,1,0,0,0,0,0,1,0,1,0,1],
        [0,0,0,0,1,0,2,2,2,0,1,0,0,0,0],
        [0,1,1,0,0,0,2,2,2,0,0,0,1,1,0],
        [0,0,0,0,1,0,2,2,2,0,1,0,0,0,0],
        [1,0,1,0,1,0,0,0,0,0,1,0,1,0,1],
        [1,0,0,0,0,0,0,1,0,0,0,0,0,0,1],
        [0,0,1,0,1,1,0,1,0,1,1,0,1,0,0],
        [0,1,1,0,0,0,0,0,0,0,0,0,1,1,0],
        [3,0,0,0,1,0,1,1,1,0,1,0,0,0,3]
      ]
    },
    { "MAPA_ARCADE": "04",
      "blockers": 90,
      "grid": [
        [3,0,0,0,0,1,0,1,0,1,0,0,0,0,3],
        [0,1,1,0,1,1,0,0,0,1,1,0,1,1,0],
        [0,0,1,0,1,0,0,1,0,0,1,0,1,0,0],
        [1,0,1,0,0,0,1,0,1,0,0,0,1,0,1],
        [0,0,0,0,1,0,0,0,0,0,1,0,0,0,0],
        [1,1,0,1,0,0,2,2,2,0,0,1,0,1,1],
        [0,0,0,0,0,1,2,2,2,1,0,0,0,0,0],
        [1,1,0,1,0,0,2,2,2,0,0,1,0,1,1],
        [0,0,0,0,1,0,0,0,0,0,1,0,0,0,0],
        [1,0,1,0,0,0,1,0,1,0,0,0,1,0,1],
        [0,0,1,0,1,0,0,1,0,0,1,0,1,0,0],
        [0,1,1,0,1,1,0,0,0,1,1,0,1,1,0],
        [3,0,0,0,0,1,0,1,0,1,0,0,0,0,3]
      ]
    },
    { "MAPA_ARCADE": "05",
      "blockers": 90,
      "grid": [
        [3,1,0,0,1,0,0,0,0,0,1,0,0,1,3],
        [0,7,0,0,0,0,1,1,1,0,0,0,0,7,0],
        [0,1,1,0,1,0,0,0,0,0,1,0,1,1,0],
        [1,1,0,0,0,0,1,0,1,0,0,0,0,1,1],
        [0,0,0,1,1,0,0,1,0,0,1,1,0,0,0],
        [0,1,0,1,0,0,2,2,2,0,0,1,0,1,0],
        [0,1,0,0,0,1,2,2,2,1,0,0,0,1,0],
        [0,1,0,1,0,0,2,2,2,0,0,1,0,1,0],
        [0,0,0,1,1,0,0,1,0,0,1,1,0,0,0],
        [1,1,0,0,0,0,1,0,1,0,0,0,0,1,1],
        [0,1,1,0,1,0,0,0,0,0,1,0,1,1,0],
        [0,7,0,0,0,0,1,1,1,0,0,0,0,7,0],
        [3,1,0,0,1,0,0,0,0,0,1,0,0,1,3]
      ]
    },
    { "MAPA_ARCADE": "06",
      "blockers": 90,
      "grid": [
        [3,0,0,1,1,0,1,1,1,0,1,1,0,0,3],
        [0,1,0,0,0,0,0,0,0,0,0,0,0,1,0],
        [0,0,1,0,1,0,0,1,0,0,1,0,1,0,0],
        [1,0,0,0,1,1,0,1,0,1,1,0,0,0,1],
        [0,0,1,0,0,0,0,0,0,0,0,0,1,0,0],
        [1,0,1,1,1,0,2,2,2,0,1,1,1,0,1],
        [1,0,0,0,0,0,2,2,2,0,0,0,0,0,1],
        [1,0,1,1,1,0,2,2,2,0,1,1,1,0,1],
        [0,0,1,0,0,0,0,0,0,0,0,0,1,0,0],
        [1,0,0,0,1,1,0,1,0,1,1,0,0,0,1],
        [0,0,1,0,1,0,0,1,0,0,1,0,1,0,0],
        [0,1,0,0,0,0,0,0,0,0,0,0,0,1,0],
        [3,0,0,1,1,0,1,1,1,0,1,1,0,0,3]
      ]
    },
    { "MAPA_ARCADE": "07",
      "blockers": 90,
      "grid": [
        [3,0,0,0,0,0,1,1,1,0,0,0,0,0,3],
        [0,1,1,0,1,0,0,1,0,0,1,0,1,1,0],
        [0,0,1,0,1,1,0,0,0,1,1,0,1,0,0],
        [1,0,0,0,0,0,0,1,0,0,0,0,0,0,1],
        [1,0,1,0,1,0,0,0,0,0,1,0,1,0,1],
        [0,0,0,1,0,0,2,2,2,0,0,1,0,0,0],
        [0,1,0,0,0,1,2,2,2,1,0,0,0,1,0],
        [0,0,0,1,0,0,2,2,2,0,0,1,0,0,0],
        [1,0,1,0,1,0,0,0,0,0,1,0,1,0,1],
        [1,0,0,0,0,0,0,1,0,0,0,0,0,0,1],
        [0,0,1,0,1,1,0,0,0,1,1,0,1,0,0],
        [0,1,1,0,1,0,0,1,0,0,1,0,1,1,0],
        [3,0,0,0,0,0,1,1,1,0,0,0,0,0,3]
      ]
    },
    { "MAPA_ARCADE": "08",
      "blockers": 90,
      "grid": [
        [3,0,0,0,0,1,0,0,0,1,0,0,0,0,3],
        [0,1,0,1,0,1,0,1,0,1,0,1,0,1,0],
        [0,0,0,0,0,0,0,1,0,0,0,0,0,0,0],
        [0,1,1,0,1,1,0,0,0,1,1,0,1,1,0],
        [0,0,0,0,0,0,0,1,0,0,0,0,0,0,0],
        [1,0,1,1,1,0,2,2,2,0,1,1,1,0,1],
        [1,0,0,1,0,0,2,2,2,0,0,1,0,0,1],
        [1,0,1,1,1,0,2,2,2,0,1,1,1,0,1],
        [0,0,0,0,0,0,0,1,0,0,0,0,0,0,0],
        [0,1,1,0,1,1,0,0,0,1,1,0,1,1,0],
        [0,0,0,0,0,0,0,1,0,0,0,0,0,0,0],
        [0,1,0,1,0,1,0,1,0,1,0,1,0,1,0],
        [3,0,0,0,0,1,0,0,0,1,0,0,0,0,3]
      ]
    },
    { "MAPA_ARCADE": "09",
      "blockers": 90,
      "grid": [
        [3,0,0,0,1,0,0,0,0,0,1,0,0,0,3],
        [0,1,1,0,0,0,1,0,1,0,0,0,1,1,0],
        [0,0,0,1,0,1,1,1,1,1,0,1,0,0,0],
        [0,1,0,0,0,1,0,0,0,1,0,0,0,1,0],
        [0,0,0,1,0,0,0,1,0,0,0,1,0,0,0],
        [0,1,0,0,1,0,2,2,2,0,1,0,0,1,0],
        [1,1,1,1,0,0,2,2,2,0,0,1,1,1,1],
        [0,1,0,0,1,0,2,2,2,0,1,0,0,1,0],
        [0,0,0,1,0,0,0,1,0,0,0,1,0,0,0],
        [0,1,0,0,0,1,0,0,0,1,0,0,0,1,0],
        [0,0,0,1,0,1,1,1,1,1,0,1,0,0,0],
        [0,1,1,0,0,0,1,0,1,0,0,0,1,1,0],
        [3,0,0,0,1,0,0,0,0,0,1,0,0,0,3]
      ]
    },
    { "MAPA_ARCADE": "10",
      "blockers": 90,
      "grid": [
        [3,0,0,1,0,0,0,1,0,0,0,1,0,0,3],
        [0,1,1,0,1,1,0,0,0,1,1,0,1,1,0],
        [0,1,1,0,1,0,0,1,0,0,1,0,1,1,0],
        [0,0,0,0,0,0,1,1,1,0,0,0,0,0,0],
        [1,0,1,0,1,0,0,0,0,0,1,0,1,0,1],
        [0,0,1,0,1,0,2,2,2,0,1,0,1,0,0],
        [1,0,0,0,0,0,2,2,2,0,0,0,0,0,1],
        [0,0,1,0,1,0,2,2,2,0,1,0,1,0,0],
        [1,0,1,0,1,0,0,0,0,0,1,0,1,0,1],
        [0,0,0,0,0,0,1,1,1,0,0,0,0,0,0],
        [0,1,1,0,1,0,0,1,0,0,1,0,1,1,0],
        [0,1,1,0,1,1,0,0,0,1,1,0,1,1,0],
        [3,0,0,1,0,0,0,1,0,0,0,1,0,0,3]
      ]
    },
    { "MAPA_ARCADE": "11",
      "blockers": 90,
      "grid": [
        [3,0,0,1,0,1,0,0,0,1,0,1,0,0,3],
        [0,1,0,0,0,1,1,0,1,1,0,0,0,1,0],
        [0,0,1,0,1,0,0,0,0,0,1,0,1,0,0],
        [1,0,0,0,0,0,1,1,1,0,0,0,0,0,1],
        [0,1,1,0,1,0,0,0,0,0,1,0,1,1,0],
        [0,0,0,0,0,0,2,2,2,0,0,0,0,0,0],
        [0,1,1,1,0,1,2,2,2,1,0,1,1,1,0],
        [0,0,0,0,0,0,2,2,2,0,0,0,0,0,0],
        [0,1,1,0,1,0,0,0,0,0,1,0,1,1,0],
        [1,0,0,0,0,0,1,1,1,0,0,0,0,0,1],
        [0,0,1,0,1,0,0,0,0,0,1,0,1,0,0],
        [0,1,0,0,0,0,1,0,1,0,0,0,0,1,0],
        [3,0,0,1,0,1,0,0,0,1,0,1,0,0,3]
      ]
    },
    { "MAPA_ARCADE": "12",
      "blockers": 90,
      "grid": [
        [3,0,0,0,1,0,0,0,0,0,1,0,0,0,3],
        [0,1,1,0,0,0,1,0,1,0,0,0,1,1,0],
        [0,1,1,0,1,0,0,1,0,0,1,0,1,1,0],
        [0,0,0,0,0,0,1,0,1,0,0,0,0,0,0],
        [1,0,1,0,1,0,0,0,0,0,1,0,1,0,1],
        [0,0,1,0,1,0,2,2,2,0,1,0,1,0,0],
        [1,0,0,1,0,0,2,2,2,0,0,1,0,0,1],
        [0,0,1,0,1,0,2,2,2,0,1,0,1,0,0],
        [1,0,1,0,1,0,0,0,0,0,1,0,1,0,1],
        [0,0,0,0,0,0,1,0,1,0,0,0,0,0,0],
        [0,1,1,0,1,0,0,1,0,0,1,0,1,1,0],
        [0,1,1,0,0,0,1,0,1,0,0,0,1,1,0],
        [3,0,0,0,1,0,0,0,0,0,1,0,0,0,3]
      ]
    },
    { "MAPA_ARCADE": "13",
      "blockers": 90,
      "grid": [
        [3,0,0,0,0,1,0,0,0,1,0,0,0,0,3],
        [0,1,0,1,0,0,0,1,0,0,0,1,0,1,0],
        [0,1,1,0,1,0,1,1,1,0,1,0,1,1,0],
        [0,0,0,0,0,0,1,1,1,0,0,0,0,0,0],
        [1,0,1,0,1,0,0,0,0,0,1,0,1,0,1],
        [1,0,0,1,0,0,2,2,2,0,0,1,0,0,1],
        [1,0,1,1,1,0,2,2,2,0,1,1,1,0,1],
        [1,0,0,1,0,0,2,2,2,0,0,1,0,0,1],
        [1,0,1,0,1,0,0,0,0,0,1,0,1,0,1],
        [0,0,0,0,0,0,1,1,1,0,0,0,0,0,0],
        [0,1,1,0,1,0,1,1,1,0,1,0,1,1,0],
        [0,1,0,1,0,0,0,1,0,0,0,1,0,1,0],
        [3,0,0,1,0,1,0,0,0,1,0,1,0,0,3]
      ]
    },
    { "MAPA_ARCADE": "14",
      "blockers": 90,
      "grid": [
        [3,0,0,0,0,0,0,1,0,0,0,0,0,0,3],
        [0,1,0,1,0,1,0,0,0,1,0,1,0,1,0],
        [0,1,1,1,0,1,1,1,1,1,0,1,1,1,0],
        [0,0,0,0,0,0,0,1,0,0,0,0,0,0,0],
        [0,1,1,0,1,1,0,0,0,1,1,0,1,1,0],
        [0,0,1,0,0,0,2,2,2,0,0,0,1,0,0],
        [1,0,1,1,1,0,2,2,2,0,1,1,1,0,1],
        [0,0,1,0,0,0,2,2,2,0,0,0,1,0,0],
        [0,1,1,0,1,1,0,0,0,1,1,0,1,1,0],
        [0,0,0,0,0,0,0,1,0,0,0,0,0,0,0],
        [0,1,1,1,0,1,1,1,1,1,0,1,1,1,0],
        [0,1,0,1,0,1,0,0,0,1,0,1,0,1,0],
        [3,0,0,0,0,0,0,1,0,0,0,0,0,0,3]
      ]
    },
    { "MAPA_ARCADE": "15",
      "blockers": 90,
      "grid": [
        [3,0,0,1,1,0,0,0,0,0,1,1,0,0,3],
        [0,1,0,0,0,0,1,1,1,0,0,0,0,1,0],
        [0,1,0,1,0,1,1,0,1,1,0,1,0,1,0],
        [0,0,0,0,0,1,0,0,0,1,0,0,0,0,0],
        [0,1,0,1,0,0,0,1,0,0,0,1,0,1,0],
        [0,0,0,1,0,1,2,2,2,1,0,1,0,0,0],
        [1,1,0,0,0,0,2,2,2,0,0,0,0,1,1],
        [0,0,0,1,0,1,2,2,2,1,0,1,0,0,0],
        [0,1,0,1,0,0,0,1,0,0,0,1,0,1,0],
        [0,0,0,0,0,1,0,0,0,1,0,0,0,0,0],
        [0,1,0,1,0,1,1,0,1,1,0,1,0,1,0],
        [0,1,0,0,0,0,1,1,1,0,0,0,0,1,0],
        [3,0,0,1,1,0,0,0,0,0,1,1,0,0,3]
      ]
    },
    { "MAPA_ARCADE": "16",
      "blockers": 90,
      "grid": [
        [3,0,0,0,0,0,0,1,0,0,0,0,0,0,3],
        [0,1,0,1,1,1,0,0,0,1,1,1,0,1,0],
        [0,1,0,0,1,0,0,1,0,0,1,0,0,1,0],
        [0,1,1,0,0,0,1,1,1,0,0,0,1,1,0],
        [0,0,0,0,1,0,0,0,0,0,1,0,0,0,0],
        [0,1,1,0,0,0,2,2,2,0,0,0,1,1,0],
        [1,1,0,0,1,0,2,2,2,0,1,0,0,1,1],
        [0,1,1,0,0,0,2,2,2,0,0,0,1,1,0],
        [0,0,0,0,1,0,0,0,0,0,1,0,0,0,0],
        [0,1,1,0,0,0,1,1,1,0,0,0,1,1,0],
        [0,1,0,0,1,0,0,1,0,0,1,0,0,1,0],
        [0,1,0,1,1,1,0,0,0,1,1,1,0,1,0],
        [3,0,0,0,0,0,0,1,0,0,0,0,0,0,3]
      ]
    },
    { "MAPA_ARCADE": "17",
      "blockers": 90,
      "grid": [
        [3,0,0,0,0,1,0,1,0,1,0,0,0,0,3],
        [0,1,0,1,0,0,0,1,0,0,0,1,0,1,0],
        [0,1,0,1,1,1,0,0,0,1,1,1,0,1,0],
        [0,0,0,0,0,1,1,1,1,1,0,0,0,0,0],
        [0,1,1,1,0,0,0,0,0,0,0,1,1,1,0],
        [0,0,1,1,0,1,2,2,2,1,0,1,1,0,0],
        [1,0,0,1,0,0,2,2,2,0,0,1,0,0,1],
        [0,0,1,1,0,1,2,2,2,1,0,1,1,0,0],
        [0,1,1,1,0,0,0,0,0,0,0,1,1,1,0],
        [0,0,0,0,0,1,1,1,1,1,0,0,0,0,0],
        [0,1,0,1,1,1,0,0,0,1,1,1,0,1,0],
        [0,1,0,1,0,0,0,1,0,0,0,1,0,1,0],
        [3,0,0,0,0,1,0,1,0,1,0,0,0,0,3]
      ]
    },
    { "MAPA_ARCADE": "18",
      "blockers": 90,
      "grid": [
        [3,0,0,1,0,0,0,0,0,0,0,1,0,0,3],
        [0,1,1,1,1,0,1,0,1,0,1,1,1,1,0],
        [0,0,0,0,0,0,0,1,0,0,0,0,0,0,0],
        [0,1,1,0,1,1,0,0,0,1,1,0,1,1,0],
        [0,1,0,0,0,0,0,1,0,0,0,0,0,1,0],
        [0,0,0,1,0,1,2,2,2,1,0,1,0,0,0],
        [1,1,0,0,0,0,2,2,2,0,0,0,0,1,1],
        [0,0,0,1,0,1,2,2,2,1,0,1,0,0,0],
        [0,1,0,0,0,0,0,1,0,0,0,0,0,1,0],
        [0,1,1,0,1,1,0,0,0,1,1,0,1,1,0],
        [0,0,0,0,0,0,0,1,0,0,0,0,0,0,0],
        [0,1,1,1,1,0,1,0,1,0,1,1,1,1,0],
        [3,0,0,1,0,0,0,0,0,0,0,1,0,0,3]
      ]
    },
    { "MAPA_ARCADE": "19",
      "blockers": 90,
      "grid": [
        [3,0,0,0,0,1,1,1,1,1,0,0,0,0,3],
        [0,1,1,0,1,0,0,0,0,0,1,0,1,1,0],
        [0,1,1,0,0,0,1,0,1,0,0,0,1,1,0],
        [0,0,0,0,1,1,0,0,0,1,1,0,0,0,0],
        [1,0,1,0,0,0,0,1,0,0,0,0,1,0,1],
        [1,0,0,1,1,0,2,2,2,0,1,1,0,0,1],
        [1,0,1,1,0,0,2,2,2,0,0,1,1,0,1],
        [1,0,0,1,1,0,2,2,2,0,1,1,0,0,1],
        [1,0,1,0,0,0,0,1,0,0,0,0,1,0,1],
        [0,0,0,0,1,1,0,0,0,1,1,0,0,0,0],
        [0,1,1,0,0,0,1,0,1,0,0,0,1,1,0],
        [0,1,1,0,1,0,0,0,0,0,1,0,1,1,0],
        [3,0,0,0,0,1,1,1,1,1,0,0,0,0,3]
      ]
    },
    { "MAPA_ARCADE": "20",
      "blockers": 90,
      "grid": [
        [3,0,0,1,0,1,1,0,1,1,0,1,0,0,3],
        [0,1,0,0,0,0,0,0,0,0,0,0,0,1,0],
        [0,0,1,0,1,0,1,1,1,0,1,0,1,0,0],
        [1,0,1,0,1,0,1,1,1,0,1,0,1,0,1],
        [0,0,0,0,0,0,0,0,0,0,0,0,0,0,0],
        [1,0,1,0,1,0,2,2,2,0,1,0,1,0,1],
        [1,0,1,1,1,0,2,2,2,0,1,1,1,0,1],
        [1,0,1,0,1,0,2,2,2,0,1,0,1,0,1],
        [0,0,0,0,0,0,0,0,0,0,0,0,0,0,0],
        [1,0,1,0,1,0,1,1,1,0,1,0,1,0,1],
        [0,0,1,0,1,0,1,1,1,0,1,0,1,0,0],
        [0,1,0,0,0,0,0,0,0,0,0,0,0,1,0],
        [3,0,0,1,0,1,1,0,1,1,0,1,0,0,3]
      ]
    }
  ]

}